Height: 688
Width: 1800
Top: 0
Left: 50
X,X,X,X,X,X,X,X,X,X,X,X,X
X,O,O,O,O,O,O,O,O,O,E,O,X
X,O,O,O,O,O,O,O,O,O,O,O,X,X,X,X,X,X,X,X,X,X,X,x,x,x,x,x,x,x,x,x,x,x,x,x,x,x,x,x,x,x,x,x
X,O,O,_,O,O,O,SC,X,D,X,X,o,o,o,o,o,o,o,o,o,o,o,o,o,o,o,o,o,o,o,o,o,o,o,o,o,o,o,o,o,o,o,x
X,O,O,O,O,O,O,O,O,O,O,O,o,o,o,o,o,o,o,o,o,o,o,o,o,o,o,o,o,o,o,o,o,o,o,o,o,o,o,o,o,o,o,x
X,O,MS,O,P,O,O,MV,O,O,E,o,o,o,o,o,o,o,o,o,o,o,o,o,o,o,o,o,o,o,o,o,o,o,o,o,o,o,o,o,o,o,o,x
X,O,O,O,C,O,D,O,O,O,O,O,o,o,o,o,o,o,o,o,o,o,o,o,o,o,o,o,o,o,o,o,o,o,o,o,o,o,o,o,o,o,o,x
X,O,O,O,O,O,O,O,O,O,O,O,X,x,x,x,x,x,x,x,x,x,x,x,x,x,X,o,o,o,o,o,o,o,o,o,o,o,o,o,o,o,o,x
X,O,O,O,O,O,O,o,o,o,o,o,X,o,o,o,o,o,o,o,o,o,o,o,o,o,x,o,o,o,o,o,o,o,o,o,o,o,o,o,o,o,o,x
X,O,O,O,O,O,O,o,o,o,o,o,X,o,o,o,o,o,o,o,o,o,o,o,o,o,d,o,o,o,o,o,o,o,o,o,o,o,o,o,o,o,o,x
X,O,O,O,O,O,O,o,o,o,o,o,X,SC,o,o,o,o,o,o,o,o,o,o,o,o,d,o,o,o,o,o,o,o,o,o,o,o,o,o,o,o,o,X
X,O,O,O,O,O,O,o,o,o,o,o,X,x,x,x,x,x,x,x,x,x,x,x,x,x,X,o,o,o,o,o,o,o,o,o,o,o,o,o,o,o,o,x
X,O,O,O,O,O,O,o,o,o,o,o,o,o,o,o,o,o,o,o,o,o,o,o,o,o,o,o,o,o,o,o,o,o,o,o,o,o,o,o,o,o,o,x
X,O,O,O,O,O,O,o,o,o,o,o,o,o,o,o,o,o,o,o,o,o,o,o,o,o,o,o,o,o,o,o,o,o,o,o,o,o,o,o,o,o,o,x
X,O,O,O,O,O,O,o,o,o,o,o,o,o,o,o,o,o,o,o,o,o,o,o,o,o,o,o,o,o,o,o,o,o,o,o,o,o,o,o,o,o,o,x
X,O,O,O,O,O,O,o,o,o,o,o,o,o,o,o,o,o,o,o,o,o,o,o,o,o,o,o,o,o,o,o,o,o,o,o,o,o,o,o,o,o,o,x
X,x,x,x,x,x,x,x,x,x,x,x,X,x,x,x,x,x,x,x,x,x,x,x,x,x,x,x,x,x,x,x,x,x,x,x,x,x,x,x,x,x,x,x