Height: 288
Width: 816
Top: 100
Left: 50
X,X,X,X,X,X,X,X,X,X,X,X,X
X,O,O,O,O,O,O,X,O,O,E,O,X
X,O,O,O,O,O,O,X,O,O,O,O,X,X,X,X,X,X,X,X,X,X,X
X,O,O,_,O,O,O,X,X,D,X,X,X,X,X,X,D,D,D,D,D,D,D
X,O,O,O,O,O,O,O,O,O,O,O,O,O,O,E,C,C,C,C,C,C,C
X,O,O,O,P,O,O,O,O,O,O,O,O,O,O,C,X,X,E,D,C,_,X
X,O,O,O,O,O,_,O,O,O,O,O,X,X,X,X
X,O,O,O,O,O,O,O,O,O,O,O,X
X,X,X,X,X,X,X,X,X,X,X,X,X